1001110000000000000000-
1001011100000000000000-
1001000100000000000000-
1001011100000000000000-
1001010000000000000000-
1111011111000000000000-
0000000001000000000000-
0000000111000000000000-
0000000100000000000000-
0000000111111111111111