1001110000-
1001011100-
1001000100-
1001011100-
1001010000-
1111011111